{
    "size":{
        "width":40,
        "height":15
    },
    "tiles":
[[ 0,  0,  0,  0,  0,  0,  0,  5,  1,  1,  1,  1,  3,  0,  0,  0,  0,  0,  0,  0,  0,  0,  0,  0,  0,  0,  0,  0,  0,  0,  0,  0,  0,  0,  0,  0,  0,  0,  0,  5],
 [ 0,  0,  0,  0,  0,  0,  0, 24,  4,  4,  4,  4, 25,  0,  0,  0,  0,  0,  0,  0,  0,  0,  0,  0,  0,  0,  0,  0,  0,  0,  0,  0,  0,  0,  0,  0,  0,  0,  0,  5],
 [ 0,  0,  0,  0,  0,  0,  0,  0,  0,  0,  0,  0,  0,  0,  0, 10, 11, 12,  0,  0,  0,  0,  0,  0,  0,  0,  0,  0,  0,  0,  0,  0,  0,  0,  0, 10, 11, 12,  0,  5],
 [ 0,  0, 10, 12,  0,  0,  0,  0,  0,  0,  0,  0,  0,  0,  0,  0,  0,  0,  0,  0,  0,  0, 10, 12,  0,  0,  0,  0,  0,  0,  0,  0,  0,  0,  0,  0,  0,  0,  0,  5],
 [ 0,  0,  0,  0,  0,  0,  0,  0,  0,  0,  0,  0,  0,  0,  0,  0,  0,  0,  0,  0,  0,  0,  0,  0,  0,  0,  0,  0,  0,  0,  0,  0,  0,  0,  0,  0,  0,  0,  0,  5],
 [ 0,  0,  0,  0,  0,  0,  0,  0,  0,  0,  0,  0,  0,  0,  0,  0,  0,  0,  0,  0,  0,  0,  0,  0,  0,  0,  0,  0,  0,  0,  0,  0,  0,  0,  0,  0,  0,  0,  0,  5],
 [ 0,  0,  0,  0,  0,  0,  0,  0, 10, 12,  0,  0,  0,  0,  0,  0,  0,  0,  0,  0,  0,  0,  0,  0,  0,  0,  0,  0, 10, 12,  0,  0,  0,  0,  0,  0,  0,  0,  0,  5],
 [ 0,  0,  0,  0,  0,  0,  0,  0,  0,  0,  0,  0,  0, 10, 12,  0,  0,  0,  0,  0,  0,  0,  0,  0,  0,  0,  0,  0,  0,  0,  0,  0,  0, 10, 12,  0,  0,  0,  0,  5],
 [11, 11, 11, 12,  0,  0,  0,  0,  0,  0,  0,  0,  0,  0,  0,  0,  0,  0,  0,  0,  0, 10, 11, 12,  0,  0,  0,  0,  0,  0,  0,  0,  0,  0,  0,  0,  0,  0,  0,  5],
 [ 0,  0,  0,  0,  0,  0,  0,  0,  0,  0,  0,  0,  0,  0,  0,  0,  0,  0,  0,  0,  0,  0,  0,  0,  0,  0,  0,  0,  0,  0,  0,  0,  0,  0,  0,  0,  0,  0,  0,  5],
 [ 0,  0,  0,  0,  0,  0, 10, 11, 11, 11, 11, 11, 11, 12,  0,  0,  0,  0,  0,  0,  0,  0,  0,  0,  0,  0, 10, 11, 11, 11, 11, 11, 11, 12,  0,  0,  0,  0,  0,  5],
 [ 0,  0,  0,  0,  0,  0,  0,  0,  0,  0,  0,  0,  0,  0,  0,  0,  0,  0,  0,  0,  0,  0,  0,  0,  0,  0,  0,  0,  0,  0,  0,  0,  0,  0,  0,  0,  0,  0,  0,  5],
 [ 0,  0, 10, 11, 12,  0,  0,  0,  0,  0,  0,  0,  0,  0,  0,  0,  0,  0,  0, 20, 22,  0, 10, 11, 12,  0,  0,  0,  0,  0,  0,  0,  0,  0,  0,  0,  0,  0,  0,  5],
 [ 0,  0,  0,  0,  0,  0,  0,  0,  0,  0,  0,  0,  0, 20,  2, 22,  0, 20,  2, 21, 23, 22,  0,  0,  0,  0,  0,  0,  0,  0,  0,  0,  0, 20,  2, 22,  0, 20,  2, 21],
 [ 2,  2,  2,  2,  2,  2,  2,  2,  2,  2,  2,  2,  2, 21,  1, 23,  2, 21,  1,  1,  1, 23,  2,  2,  2,  2,  2,  2,  2,  2,  2,  2,  2, 21,  1, 23,  2, 21,  1,  1]]}