[[ 3,  0,  0,  0,  0,  0,  0,  5,  1,  1,  1,  1,  3,  0,  0,  0,  0,  0,  0,  5],
 [ 3,  0,  0,  0,  0,  0,  0, 24,  4,  4,  4,  4, 25,  0,  0,  0,  0,  0,  0,  5],
 [ 3,  0,  0,  0,  0,  0,  0,  0,  0,  0,  0,  0,  0,  0,  0, 10, 11, 12,  0,  5],
 [ 3,  0, 10, 12,  0,  0,  0,  0,  0,  0,  0,  0,  0,  0,  0,  0,  0,  0,  0,  5],
 [ 3,  0,  0,  0,  0,  0,  0,  0,  0,  0,  0,  0,  0,  0,  0,  0,  0,  0,  0,  5],
 [ 3,  0,  0,  0,  0,  0,  0,  0,  0,  0,  0,  0,  0,  0,  0,  0,  0,  0,  0,  5],
 [ 3,  0,  0,  0,  0,  0,  0,  0, 10, 12,  0,  0,  0,  0,  0,  0,  0,  0,  0,  5],
 [ 3,  0,  0,  0,  0,  0,  0,  0,  0,  0,  0,  0,  0, 10, 12,  0,  0,  0,  0,  5],
 [ 3, 11, 11, 12,  0,  0,  0,  0,  0,  0,  0,  0,  0,  0,  0,  0,  0,  0,  0,  5],
 [ 3,  0,  0,  0,  0,  0,  0,  0,  0,  0,  0,  0,  0,  0,  0,  0,  0,  0,  0,  5],
 [ 3,  0,  0,  0,  0,  0, 10, 11, 11, 11, 11, 11, 11, 12,  0,  0,  0,  0,  0,  5],
 [ 3,  0,  0,  0,  0,  0,  0,  0,  0,  0,  0,  0,  0,  0,  0,  0,  0,  0,  0,  5],
 [ 3,  0, 10, 11, 12,  0,  0,  0,  0,  0,  0,  0,  0,  0,  0,  0,  0, 20,  2, 21],
 [ 3,  0,  0,  0,  0,  0,  0,  0,  0,  0,  0,  0,  0,  0,  0,  0, 20, 21,  1,  1],
 [23,  2,  2,  2,  2,  2,  2,  2,  2,  2,  2,  2,  2,  2,  2,  2, 21,  1,  1,  1]]